[
    {
        "id_map": 1,
        "grid": [
            [1, 1, 1, 1, 1, 1, 1],
            [1, 1, 1, 1, 1, 1, 1],
            [1, 1, 4, 0, 0, 1, 1],
            [1, 1, 0, 2, 0, 3, 1],
            [1, 1, 0, 0, 0, 1, 1],
            [1, 1, 1, 1, 1, 1, 1],
            [1, 1, 1, 1, 1, 1, 1]
        ]
    },
    {
        "id_map": 2,
        "grid": [
            [1, 1, 1, 1, 1, 1, 1],
            [1, 0, 0, 0, 0, 0, 1],
            [1, 0, 0, 0, 2, 4, 1],
            [1, 0, 3, 0, 0, 0, 1],
            [1, 0, 3, 0, 2, 0, 1],
            [1, 0, 0, 0, 0, 0, 1],
            [1, 1, 1, 1, 1, 1, 1]
        ]
    },
    {
        "id_map": 3,
        "grid": [
            [1, 1, 1, 1, 1, 1, 1],
            [1, 4, 0, 0, 3, 1, 1],
            [1, 0, 2, 0, 3, 1, 1],
            [1, 0, 2, 2, 3, 1, 1],
            [1, 0, 0, 0, 0, 1, 1],
            [1, 0, 0, 0, 0, 1, 1],
            [1, 1, 1, 1, 1, 1, 1]
        ]
    },
    {
        "id_map": 4,
        "grid": [
            [0, 0, 1, 1, 1, 0, 0, 0],
            [0, 0, 1, 3, 1, 0, 0, 0],
            [0, 0, 1, 0, 1, 1, 1, 1],
            [1, 1, 1, 2, 4, 2, 3, 1],
            [1, 3, 0, 2, 2, 1, 1, 1],
            [1, 1, 1, 1, 0, 1, 0, 0],
            [0, 0, 0, 1, 0, 1, 0, 0],
            [0, 0, 0, 1, 3, 1, 0, 0],
            [0, 0, 0, 1, 1, 1, 0, 0]
        ]
    },
    {
        "id_map": 5,
        "grid": [
            [1, 1, 1, 1, 1, 1, 1, 1],
            [1, 4, 0, 0, 0, 0, 3, 1],
            [1, 0, 2, 2, 2, 0, 3, 1],
            [1, 0, 0, 2, 0, 0, 3, 1],
            [1, 0, 0, 2, 0, 0, 3, 1],
            [1, 0, 0, 0, 0, 0, 3, 1],
            [1, 0, 0, 0, 0, 0, 0, 1],
            [1, 1, 1, 1, 1, 1, 1, 1]
        ]
    },
    {
        "id_map": 6,
        "grid": [
            [0, 0, 1, 1, 1, 1, 1, 0],
            [1, 1, 1, 0, 0, 0, 1, 0],
            [1, 3, 4, 2, 0, 0, 1, 0],
            [1, 1, 1, 0, 2, 3, 1, 0],
            [1, 3, 1, 1, 2, 0, 1, 0],
            [1, 0, 1, 0, 3, 0, 1, 1],
            [1, 2, 0, 6, 2, 2, 3, 1],
            [1, 0, 0, 0, 3, 0, 0, 1],
            [1, 1, 1, 1, 1, 1, 1, 1]
        ]
    },
    {
        "id_map": 7,
        "grid": [
            [1, 1, 1, 1, 1, 1, 1, 1, 1, 1, 1, 1, 1],
            [1, 0, 0, 0, 1, 0, 0, 0, 1, 0, 0, 0, 1],
            [1, 0, 2, 0, 2, 0, 0, 0, 2, 0, 2, 0, 1],
            [1, 0, 0, 1, 1, 0, 3, 0, 1, 1, 0, 0, 1],
            [1, 0, 2, 1, 0, 3, 3, 3, 0, 1, 2, 0, 1],
            [1, 0, 0, 0, 3, 3, 1, 3, 3, 0, 0, 0, 1],
            [1, 0, 2, 1, 0, 3, 3, 3, 0, 1, 2, 0, 1],
            [1, 0, 0, 1, 1, 0, 3, 0, 1, 1, 0, 0, 1],
            [1, 0, 2, 0, 2, 0, 4, 0, 2, 0, 2, 0, 1],
            [1, 0, 0, 0, 1, 0, 0, 0, 1, 0, 0, 0, 1],
            [1, 1, 1, 1, 1, 1, 1, 1, 1, 1, 1, 1, 1]
        ]
    },
    {
        "id_map": 8,
        "grid": [
            [0, 0, 1, 1, 1, 1, 1, 0, 0, 0, 0, 0, 0, 0, 0, 0, 0],
            [1, 1, 1, 0, 0, 0, 1, 1, 0, 0, 0, 0, 0, 0, 0, 0, 0],
            [1, 0, 0, 0, 1, 0, 0, 1, 0, 0, 0, 0, 0, 0, 0, 0, 0],
            [1, 0, 1, 0, 2, 0, 0, 1, 1, 1, 1, 1, 1, 1, 1, 1, 1],
            [1, 0, 2, 2, 0, 0, 0, 1, 1, 0, 0, 1, 0, 0, 0, 0, 1],
            [1, 1, 0, 0, 0, 2, 0, 1, 0, 0, 1, 1, 1, 0, 1, 0, 1],
            [0, 1, 0, 1, 2, 0, 2, 2, 0, 2, 0, 1, 0, 0, 2, 0, 1],
            [0, 1, 0, 0, 2, 0, 0, 0, 3, 3, 3, 3, 0, 2, 0, 1, 1],
            [1, 1, 1, 4, 1, 1, 0, 3, 3, 3, 3, 3, 3, 1, 1, 1, 0],
            [1, 0, 0, 0, 0, 1, 0, 0, 3, 3, 3, 3, 0, 1, 0, 0, 0],
            [1, 0, 0, 2, 0, 0, 0, 0, 0, 0, 2, 1, 1, 1, 0, 0, 0],
            [1, 0, 2, 0, 0, 0, 0, 1, 0, 0, 0, 1, 0, 0, 0, 0, 0],
            [1, 0, 0, 0, 0, 0, 1, 1, 1, 1, 1, 1, 0, 0, 0, 0, 0],
            [1, 1, 1, 1, 1, 1, 1, 0, 0, 0, 0, 0, 0, 0, 0, 0, 0]
        ]
    },
    {
        "id_map": 9,
        "grid": [
            [1, 1, 1, 1, 1, 1, 1, 1, 1, 1, 1, 1, 1, 1, 1],
            [1, 0, 0, 0, 0, 0, 1, 3, 3, 3, 1, 0, 0, 0, 1],
            [1, 0, 0, 2, 0, 0, 1, 3, 6, 3, 1, 0, 2, 0, 1],
            [1, 0, 2, 1, 2, 0, 1, 3, 3, 3, 1, 0, 2, 0, 1],
            [1, 0, 2, 0, 2, 0, 0, 3, 3, 3, 0, 0, 2, 0, 1],
            [1, 1, 0, 0, 0, 1, 1, 1, 3, 1, 1, 1, 0, 0, 1],
            [1, 3, 3, 3, 3, 3, 0, 0, 4, 0, 0, 0, 0, 0, 1],
            [1, 1, 0, 0, 0, 1, 1, 1, 0, 1, 1, 1, 0, 0, 1],
            [1, 0, 2, 0, 2, 0, 0, 0, 0, 0, 0, 0, 2, 0, 1],
            [1, 0, 2, 1, 2, 0, 1, 0, 2, 0, 1, 0, 2, 0, 1],
            [1, 0, 2, 0, 0, 0, 1, 0, 2, 0, 1, 0, 0, 0, 1],
            [1, 1, 1, 1, 1, 1, 1, 1, 1, 1, 1, 1, 1, 1, 1]
        ]
    },
    {
        "id_map": 10,
        "grid": [
            [0, 0, 0, 0, 0, 1, 1, 1, 1, 1, 1, 1, 1, 1, 1, 1, 0, 0, 0],
            [0, 0, 0, 0, 0, 1, 0, 0, 3, 0, 0, 1, 0, 0, 0, 1, 0, 0, 0],
            [0, 0, 0, 0, 0, 1, 0, 1, 3, 0, 0, 0, 0, 4, 0, 1, 0, 0, 0],
            [0, 1, 1, 1, 1, 1, 0, 1, 1, 3, 3, 1, 0, 1, 1, 1, 1, 0, 0],
            [1, 1, 0, 0, 1, 0, 3, 3, 1, 1, 1, 0, 0, 0, 0, 0, 1, 1, 1],
            [1, 0, 2, 0, 1, 3, 3, 3, 0, 0, 0, 2, 0, 1, 0, 0, 2, 0, 1],
            [1, 0, 0, 0, 0, 3, 3, 0, 1, 1, 0, 0, 1, 1, 0, 1, 1, 0, 1],
            [1, 1, 1, 1, 2, 1, 1, 2, 1, 0, 2, 0, 1, 0, 0, 0, 1, 0, 1],
            [0, 0, 1, 1, 0, 1, 0, 0, 0, 0, 1, 2, 0, 2, 2, 0, 1, 0, 1],
            [0, 0, 1, 0, 0, 2, 0, 1, 0, 1, 0, 0, 1, 0, 2, 1, 1, 0, 1],
            [0, 0, 1, 0, 0, 0, 0, 0, 0, 0, 0, 0, 0, 0, 0, 0, 0, 0, 1],
            [0, 0, 1, 0, 0, 1, 1, 1, 1, 1, 1, 1, 1, 1, 1, 1, 0, 0, 1],
            [0, 0, 1, 1, 1, 1, 0, 0, 0, 0, 0, 0, 0, 0, 0, 1, 1, 1, 1]
        ]
    }
]